+---+---+---+---+---+---+---+---+---+---+---+---+---+---+---+
|       |               |   |               | G |           |
+---+   +---+   +   +---+   +   +---+---+---+ * +   +---+---+
|               |   |           |   |   |   | * * *         |
+---+   +---+   +---+---+   +---+   +   +   +---+ * +---+---+
|       |                   |   |           |   | * |       |
+   +---+   +   +---+---+   +   +   +---+---+   + * +---+   +
|   |       |   |       |               |   |   | *         |
+   +---+---+   +---+   +   +---+---+---+   +   + * +---+---+
|   |           |   |       |   |       |     * * *         |
+---+---+---+---+   +   +   +   +   +   +---+ * +---+---+---+
|   |       |           |   |   |   |   |   | * |   |   |   |
+   +---+   +---+---+   +---+   +   +---+   + * +   +   +   +
|   |           |   |               |       | * * *     |   |
+   +---+   +---+   +---+   +---+---+---+   +---+ * +---+   +
|                               |   |   |   |   | * |       |
+---+---+---+   +---+   +---+   +   +   +   +   + * +   +   +
|               |   |   |     * * * * * * * * * * *     |   |
+   +   +   +---+   +---+---+ * +---+   +   +---+---+   +---+
|   |   |   |           |     * |       |       |           |
+---+---+---+---+---+   +---+ * +---+---+---+---+---+   +---+
|   |           |       | * * *         |   |   |           |
+   +   +   +   +---+   + * +---+   +   +   +   +---+   +---+
|       |   |   |     * * * |       |   |                   |
+---+   +---+   +---+ * +   +---+   +---+---+---+   +   +---+
|       |             * |   |       |           |   |       |
+   +---+---+---+---+ * +---+---+   +---+---+   +   +---+   +
|   |       |   |     * * * |       |               |       |
+   +---+   +   +   +---+ * +---+---+   +---+   +   +---+   +
|   |                   | * * S     |       |   |       |   |
+---+---+---+---+---+---+---+---+---+---+---+---+---+---+---+
