+---+---+---+---+---+---+---+---+---+---+---+---+---+---+---+
|       |               |   |               | G |           |
+---+   +---+   +   +---+   +   +---+---+---+   +   +---+---+
|               |   |           |   |   |   |               |
+---+   +---+   +---+---+   +---+   +   +   +---+   +---+---+
|       |                   |   |           |   |   |       |
+   +---+   +   +---+---+   +   +   +---+---+   +   +---+   +
|   |       |   |       |               |   |   |           |
+   +---+---+   +---+   +   +---+---+---+   +   +   +---+---+
|   |           |   |       |   |       |                   |
+---+---+---+---+   +   +   +   +   +   +---+   +---+---+---+
|   |       |           |   |   |   |   |   |   |   |   |   |
+   +---+   +---+---+   +---+   +   +---+   +   +   +   +   +
|   |           |   |               |       |           |   |
+   +---+   +---+   +---+   +---+---+---+   +---+   +---+   +
|                               |   |   |   |   |   |       |
+---+---+---+   +---+   +---+   +   +   +   +   +   +   +   +
|               |   |   |                               |   |
+   +   +   +---+   +---+---+   +---+   +   +---+---+   +---+
|   |   |   |           |       |       |       |           |
+---+---+---+---+---+   +---+   +---+---+---+---+---+   +---+
|   |           |       |               |   |   |           |
+   +   +   +   +---+   +   +---+   +   +   +   +---+   +---+
|       |   |   |           |       |   |                   |
+---+   +---+   +---+   +   +---+   +---+---+---+   +   +---+
|       |               |   |       |           |   |       |
+   +---+---+---+---+   +---+---+   +---+---+   +   +---+   +
|   |       |   |           |       |               |       |
+   +---+   +   +   +---+   +---+---+   +---+   +   +---+   +
|   |                   |     S     |       |   |       |   |
+---+---+---+---+---+---+---+---+---+---+---+---+---+---+---+