##############################################################
##  ##  ##  ##                  ##                  ##  ##  ##
##  ##  ##  ##  ##  ######  ##############  ##########  ##  ##
##          ##  ##      ##  ##  ##                  ##  ##  ##
######  ##  ######  ##########  ##########  ##  ######  ##  ##
##      ##  ##  ##      ##  ##      ##  ##  ##  ##          ##
##  ######  ##  ##  ######  ##  ##  ##  ##  ######  ##########
##  ##          ##  ##      ##  ##  ##      ##              ##
##########  ######  ##  ##########  ##  ######  ######  ##  ##
##  ##  ##      ##      ##  ##              ##  ##  ##  ##  ##
##  ##  ##  ######  ######  ##  ##############  ##  ##########
##  ##  ##              ##      ##                          ##
##  ##  ######  ##############  ##  ##############  ##  ######
##  ##  ##      ##              ##              ##  ##      ##
##  ##  ######  ######  ######  ##  ######  ##  ##############
##  ##              ##  ##      ##  ##      ##          ##  ##
##  ##  ##  ##  ######  ##########  ##################  ##  ##
##      ##  ##  ##  ##      ##              ##  ##  ##      ##
##  ##  ##  ######  ##  ######  ##############  ##  ##  ######
##  ##  ##      ##                  ##              ##      ##
##  ######  ##########  ######  ##############  ##############
##  ##  ##                  ##      ##                      ##
##  ##  ##  ##  ##########  ######  ##########  ##########  ##
##      ##  ##      ##  ##      ##                      ##  ##
##  ##########  ######  ##  ##  ######  ##  ##  ##############
##  ##  ##  ##      ##  ##  ##      ##  ##  ##              ##
######  ##  ##  ######  ######################  ######  ######
##                                  ##              ##      ##
##  ##  ##  ##  ##########  ##  ##  ##########  ##########  ##
##  ##  ##  ##      ##      ##  ##  ##                  ##  ##
##############################################################