##########################################
##                                      ##
##  ##  ######################  ######  ##
##  ##          ##                  ##  ##
##  ##  ######  ######  ##  ##  ##  ######
##  ##      ##  ##      ##  ##  ##      ##
##  ##  ######  ##  ##  ##  ##  ##  ##  ##
##  ##      ##  ##  ##  ##  ##  ##  ##  ##
##  ######  ##  ######  ##########  ######
##  ##      ##      ##  ##              ##
##  ######  ##############  ##  ######  ##
##  ##              ##      ##      ##  ##
##  ##  ##  ##  ##########  ##  ######  ##
##  ##  ##  ##  ##          ##      ##  ##
##  ######  ##########  ##  ######  ######
##  ##      ##          ##      ##      ##
######  ######  ##  ##  ##  ##  ##  ##  ##
##          ##  ##  ##  ##  ##  ##  ##  ##
##  ##########  ##########  ######  ######
##  ##          ##              ##      ##
##########################################