+---+---+---+---+---+---+---+---+---+---+
|                                       |
+   +---+   +---+---+---+---+   +---+   +
|   | S         |                   |   |
+   +---+   +   +   +---+   +   +---+   +
|   |       |   |       |   |   |       |
+   +   +---+   +   +   +   +   +   +   +
|   |       |   |   |   |   |   |   |   |
+   +---+   +   +---+   +---+   +---+---+
|   |       |       |   |               |
+   +---+   +---+---+---+   +   +---+   +
|   |               |       |       |   |
+   +   +   +   +   +---+---+---+   +   +
|   |   |   |   |           |       |   |
+   +---+   +---+---+   +---+   +   +---+
|   |       |           |       |       |
+---+---+   +   +   +   +   +   +   +   +
|           |   |   |   |   |   |   |   |
+   +---+---+   +---+---+   +---+---+   +
|   |           | G             |       |
+---+---+---+---+---+---+---+---+---+---+