######################
##  ##      ##      ##
##  ##  ##  ##  ######
##  ##  ##  ##      ##
##  ######  ######  ##
##  ##      ##      ##
##  ##  ##  ######  ##
##      ##          ##
##############  ######
##                  ##
######################

