+---+---+---+---+---+---+---+---+---+---+
|         * * * * * * * * * * *         |
+   +---+ * +---+---+---+---+ * +---+   +
|   | S * *     |             *     |   |
+   +---+   +   +   +---+   + * +---+   +
|   |       |   |       |   | * |       |
+   +   +---+   +   +   +   + * +   +   +
|   |       |   |   |   |   | * |   |   |
+   +---+   +   +---+   +---+ * +---+---+
|   |       |       |   |     *         |
+   +---+   +---+---+---+   + * +---+   +
|   |               |       | * * * |   |
+   +   +   +   +   +---+---+---+ * +   +
|   |   |   |   |           | * * * |   |
+   +---+   +---+---+   +---+ * +   +---+
|   |       |           | * * * |       |
+---+---+   +   +   +   + * +   +   +   +
|           |   |   |   | * |   |   |   |
+   +---+---+   +---+---+ * +---+---+   +
|   |           | G * * * *     |       |
+---+---+---+---+---+---+---+---+---+---+
