+---+---+---+---+---+
|                   |
+   +   +   +   +   +
|   |   |   |   |   |
+   +---+   +---+---+
|   |               |
+   +   +---+---+   +
|   |   |           |
+   +   +   +   +   +
| S |   |   | G |   |
+---+---+---+---+---+