+---+---+---+---+---+
| S * *     |       |
+---+ * +---+---+   +
|   | * |       |   |
+   + * +---+   +   +
|     * * * * * |   |
+---+   +   + * +   +
|   |   |   | *     |
+   +   +---+ * +---+
|       |     * * G |
+---+---+---+---+---+
