+---+---+---+---+---+
| S * * * * |       |
+---+---+ * +---+   +
|       | *     |   |
+   +---+ * +---+   +
|         * * * * * |
+   +   +   +---+ * +
|   |   |   |     * |
+   +---+   +---+ * +
|       |   |     G |
+---+---+---+---+---+
