######################
##[]##      ##      ##
##::##  ##  ##  ######
##::##  ##  ##      ##
##::######  ######  ##
##::##::::::##      ##
##::##::##::######  ##
##::::::##::::::    ##
##############::######
##            ::::><##
######################