+---+---+---+---+---+
| S |       |     G |
+   +   +   +   +---+
|   |   |   |       |
+   +---+   +---+   +
|   |       |       |
+   +   +   +---+   +
|       |           |
+---+---+---+   +---+
|                   |
+---+---+---+---+---+