+---+---+---+---+---+
| * * * * *         |
+ * +   + * +   +   +
| * |   | * |   |   |
+ * +---+ * +---+---+
| * |     * * * * * |
+ * +   +---+---+ * +
| * |   |     * * * |
+ * +   +   + * +   +
| S |   |   | G |   |
+---+---+---+---+---+
