+---+---+---+---+---+
| S         |       |
+---+   +---+---+   +
|   |   |       |   |
+   +   +---+   +   +
|               |   |
+---+   +   +   +   +
|   |   |   |       |
+   +   +---+   +---+
|       |         G |
+---+---+---+---+---+