######################
##[]::::##          ##
######::##  ######  ##
##  ##::::::    ##  ##
##  ##  ##::##########
##      ##::        ##
##########::##########
##  ##    ::::::::::##
##  ##  ##  ######::##
##      ##  ##    ><##
######################
