##############################################################
##[]##  ##  ##                  ##                  ##  ##  ##
##::##  ##  ##  ##  ######  ##############  ##########  ##  ##
##::::::::::##  ##      ##  ##  ##                  ##  ##  ##
######  ##::######  ##########  ##########  ##  ######  ##  ##
##      ##::##  ##      ##  ##      ##  ##  ##  ##          ##
##  ######::##  ##  ######  ##  ##  ##  ##  ######  ##########
##  ##    ::    ##  ##      ##  ##  ##      ##              ##
##########::######  ##  ##########  ##  ######  ######  ##  ##
##  ##  ##::    ##      ##  ##              ##  ##  ##  ##  ##
##  ##  ##::######  ######  ##  ##############  ##  ##########
##  ##  ##::::::        ##      ##                          ##
##  ##  ######::##############  ##  ##############  ##  ######
##  ##  ##    ::##              ##              ##  ##      ##
##  ##  ######::######  ######  ##  ######  ##  ##############
##  ##    ::::::    ##  ##      ##  ##      ##          ##  ##
##  ##  ##::##  ######  ##########  ##################  ##  ##
##      ##::##  ##  ##      ##              ##  ##  ##      ##
##  ##  ##::######  ##  ######  ##############  ##  ##  ######
##  ##  ##::    ##    ::::::::::    ##              ##      ##
##  ######::##########::######::##############  ##############
##  ##  ##::::::::::::::    ##::::::##                      ##
##  ##  ##  ##  ##########  ######::##########  ##########  ##
##      ##  ##      ##  ##      ##::::::::::::::        ##  ##
##  ##########  ######  ##  ##  ######  ##  ##::##############
##  ##  ##  ##      ##  ##  ##      ##  ##  ##::::::::::    ##
######  ##  ##  ######  ######################  ######::######
##                                  ##              ##::::::##
##  ##  ##  ##  ##########  ##  ##  ##########  ##########::##
##  ##  ##  ##      ##      ##  ##  ##                  ##><##
##############################################################
