##########################################
##[]::::::::::::::::::::::::::::        ##
##  ##  ######################::######  ##
##  ##          ##            ::::::##  ##
##  ##  ######  ######  ##  ##  ##::######
##  ##      ##  ##      ##  ##  ##::    ##
##  ##  ######  ##  ##  ##  ##  ##::##  ##
##  ##      ##  ##  ##  ##  ##  ##::##  ##
##  ######  ##  ######  ##########::######
##  ##      ##      ##  ##    ::::::    ##
##  ######  ##############  ##::######  ##
##  ##              ##      ##::    ##  ##
##  ##  ##  ##  ##########  ##::######  ##
##  ##  ##  ##  ##          ##::::::##  ##
##  ######  ##########  ##  ######::######
##  ##      ##          ##      ##::    ##
######  ######  ##  ##  ##  ##  ##::##  ##
##          ##  ##  ##  ##  ##  ##::##  ##
##  ##########  ##########  ######::######
##  ##          ##              ##::::><##
##########################################
