+---+---+---+---+---+
| S         |       |
+---+---+   +---+   +
|       |       |   |
+   +---+   +---+   +
|                   |
+   +   +   +---+   +
|   |   |   |       |
+   +---+   +---+   +
|       |   |     G |
+---+---+---+---+---+