+---+---+---+---+---+---+---+---+---+---+---+---+---+---+---+---+---+---+---+---+
|   |                   |   |   |   |       |       |       |       |     * * * |
+   +---+---+---+---+   +   +   +   +   +   +---+   +   +---+---+   +   + * + * +
|   |               |                   |   |       |       |   |   |   | * | S |
+   +   +---+---+   +   +---+   +---+   +   +   +---+---+   +   +   +---+ * +---+
|   |       |   |       |           |   |   |       |     * * * * * * * | * |   |
+   +---+   +   +---+   +---+---+---+   +   +   +---+---+ * +   +---+ * + * +   +
|               |       |   |   |   |   |     * * * * * * * |       | * * *     |
+   +---+---+   +   +---+   +   +   +   +---+ * +---+---+---+   +---+---+---+   +
|   |           |       |               |     * * * * *     |       |           |
+---+---+---+---+---+---+---+---+---+---+---+---+---+ * +---+---+---+---+---+---+
|                                   |       | * * * * * |   |   |   |           |
+---+---+---+---+---+---+   +---+---+   +   + * +   +---+   +   +   +   +   +   +
|       |           |   |   |   |       |     * |       |           |   |   |   |
+   +   +   +---+   +   +   +   +   +---+---+ * +---+   +---+   +---+---+---+   +
|   |           |                   | * * * | * |       |           |           |
+---+---+---+---+---+---+---+---+   + * + * + * +   +---+---+   +   +---+   +---+
|       |   |   |           |       | * | * * * |               |   |       |   |
+---+   +   +   +   +---+---+---+   + * +---+---+---+---+---+   +---+   +---+   +
|       |       |   |       |       | * | * * * |   |       |                   |
+   +---+---+   +   +   +   +   +---+ * + * + * +   +   +   +   +---+---+   +---+
|       |               |   |       | * * * | * |       |           |           |
+---+   +---+   +---+   +---+   +---+---+---+ * +---+---+---+---+---+---+---+---+
|       |       |                   |   |   | * |   |   |   |   |               |
+---+   +---+---+---+---+---+---+   +   +   + * +   +   +   +   +---+   +---+---+
|       |   |           |   |       |     * * *     |           |       |   |   |
+   +---+   +   +---+   +   +   +---+---+ * +---+---+   +---+   +   +   +   +   +
|       |           |   |           |     * * * * *     |   |   |   |   |       |
+   +---+---+---+   +   +   +---+---+   +   +---+ * +   +   +   +   +---+   +   +
|   |   |           |       |       |   |   |     * |       |   |           |   |
+   +   +---+---+   +   +   +   +   +---+---+---+ * +---+---+---+---+---+   +---+
|                   |   |       |   |           | * |           |               |
+   +---+---+---+---+---+   +---+---+   +   +   + * +---+   +---+---+   +---+---+
|       |                           |   |   | * * * |           |       |       |
+---+---+---+---+---+---+---+---+   +   +---+ * +---+   +---+---+---+   +   +   +
|   |                       |   |   |       | * * * * * * * * * * * * * |   |   |
+   +   +   +---+---+   +   +   +   +---+---+   +---+   +---+---+   + * +   +---+
|   |   |       |   |   |   |       |       |       |   |       |   | * |   | G |
+   +   +---+   +   +   +   +   +   +   +   +   +   +   +   +   +---+ * +   + * +
|       |           |   |       |   |   |       |   |       |   |     * * * * * |
+---+---+---+---+---+---+---+---+---+---+---+---+---+---+---+---+---+---+---+---+
