+---+---+---+---+---+
| S |       | * * G |
+ * +   +   + * +---+
| * |   |   | * * * |
+ * +---+   +---+ * +
| * | * * * |     * |
+ * + * + * +---+ * +
| * * * | * * * * * |
+---+---+---+   +---+
|                   |
+---+---+---+---+---+
